###############################################################
#                                                             #
#                                                         @   #
# ################################### #########################
#                                                             #
############################ ##################################
#                                                             #
#                                                             #
#  ################################################ ###########
#                                                             #
#                                                             #
############ ####################### ##########################
#                                                             #
#                                                             #
############################################################# #
#                                                             #
#                                                             #
###############################################################