###############################################################
#                                                             #
#                                                             #
#  ##################################  ########################
#                                                             # 
############################ ##################################
#                                                             #
#                                                             #
#  ###############################################  ###########
#                                                             #
#                                                             #
###########  ######################  ##########################
#                                                             #
#                                                             #
###########################################################   #
#                                                             #
#                                                             
###############################################################